Difficult II
0
13 11
--00000000000
-002024202020
-020202020200
-002020202020
-020202020200
------2------
1-0000000-1--
110-0-0-011--
01100010110--
-0110-1110---
--0111110----



