Difficult
0
12 10 
-00000400000
-02020202020
000202020200
002020202020
------2-----
-----01000--
-----11-10--
-----01110--
----0010110-
----0111110-