Gigant
0
17 14
------110000-000-
-----11302000020-
----1131-0-0-20--
---1131-0-0-0200-
---111-00-0000-0-
00--0-0000000000-
042020---00-0-0--
020002000-0-000--
--22000-0-0-0-0--
--0002000-0-0----
--02-0-----000000
--2000-----000-00
--00--------00000
--00--------0000-

