.level III
0
9 8
000090000
024222220
000000000
----0----
---100---
---100---
---111---
---100---
