.level IV
0
8 7
---040--
---030--
00003000
01332330
00003000
---030--
---000--
