.level 0
0
9 7
--000----
--212----
000102000
0--2--040
00010----
--010----
--000----