18 16
00000W000WW000W000
0000000W0W00W00000
0000W0WW000WW0W000
0W00000WWW0W00WWWW
0W0WW00000000WWWW0
0W00W00WW0WW0W0000
0WW0W00000000W00W0
0WW0W000WWW00000W0
0000000000000000W0
0WW0W000WWW00000W0
0WW0W00000000W0000
0000W00WW0WW0WWWW0
W0WWW000000000W000
00W000WWW0WWW0W000
0WW0W000W000W0WWW0
0000WWW000W0000000